o...ww...o
wXXXwwXXXw
..wXXXXw..
.wwwXXwww.
X........X
w...ww...w
X..X..X..X
.wXw..wXw.
.wXw..wXw.
X..X..X..X
w...ww...w
X........X
.wwwXXwww.
..wXXXXw..
wXXXwwXXXw
o...ww...o
