o..w..ww..w..o
.w.X..XX..X.w.
w.X.wwwwww.X.w
w..w......w..w
.wX.ww..ww.Xw.
ww.w......w.ww
...wX....Xw...
...wX....Xw...
ww.w......w.ww
.wX.ww..ww.Xw.
w..w......w..w
w.X.wwwwww.X.w
.w.X..XX..X.w.
o..w..ww..w..o
