o..w..www.X..X.www..w..o
.Xw.X.wwww....wwww.X.wX.
w....wX.ww.ww.ww.Xw....w
w.w......wX..Xw......w.w
..www...ww.ww.ww...www..
.XwwX.X.X.w..w.X.X.XwwX.
Xwww.w.www....www.w.wwwX
.wXwX.www.wwww.www.XwXw.
.www..wwXX.ww.XXww..www.
Xwww.Xw..wwwwww..wX.wwwX
Xwww.Xw..wwwwww..wX.wwwX
.www..wwXX.ww.XXww..www.
.wXwX.www.wwww.www.XwXw.
Xwww.w.www....www.w.wwwX
.XwwX.X.X.w..w.X.X.XwwX.
..www...ww.ww.ww...www..
w.w......wX..Xw......w.w
w....wX.ww.ww.ww.Xw....w
.Xw.X.wwww....wwww.X.wX.
o..w..www.X..X.www..w..o
