o.....ww.....o
.ww.w.ww.w.ww.
.....wwww.....
www.w....w.www
ww....ww....ww
Xwww.XXXX.wwwX
X..wwwwwwww..X
X..wwwwwwww..X
Xwww.XXXX.wwwX
ww....ww....ww
www.w....w.www
.....wwww.....
.ww.w.ww.w.ww.
o.....ww.....o
