o...wwXXww...o
XXw..wXXw..wXX
X.wwwXXXXwww.X
....w....w....
.wX..X..X..Xw.
.wXw.XXXX.wXw.
w.wwX.XX.Xww.w
w.wwX.XX.Xww.w
.wXw.XXXX.wXw.
.wX..X..X..Xw.
....w....w....
X.wwwXXXXwww.X
XXw..wXXw..wXX
o...wwXXww...o
