o...wwXXXw....wXXXww...o
wXX.wwwXX......XXwww.XXw
.w...wX..X....X..Xw...w.
wXw.XXw.wwX..Xww.wXX.wXw
X...XwX...X..X...XwX...X
wXXX.w.X.XXXXXX.X.w.XXXw
wX.w.w.X.wXwwXw.X.w.w.Xw
X.X.wwwwwwX..Xwwwwww.X.X
w..wX...wXX..XXw...Xw..w
ww..w.w.ww.ww.ww.w.w..ww
ww..w.w.ww.ww.ww.w.w..ww
w..wX...wXX..XXw...Xw..w
X.X.wwwwwwX..Xwwwwww.X.X
wX.w.w.X.wXwwXw.X.w.w.Xw
wXXX.w.X.XXXXXX.X.w.XXXw
X...XwX...X..X...XwX...X
wXw.XXw.wwX..Xww.wXX.wXw
.w...wX..X....X..Xw...w.
wXX.wwwXX......XXwww.XXw
o...wwXXXw....wXXXww...o
