o.ww....wXXwwwXXwwwXXw....ww.o
..w.ww.w..w.w.ww.w.w..w.ww.w..
w.w.w..w.wwwww..wwwww.w..w.w.w
w..w..ww..wwXXwwXXww..ww..w..w
w..wX.wXw.w.ww..ww.w.wXw.Xw..w
w...X...ww.Xw.ww.wX.ww...X...w
.w.wwwww.www..XX..www.wwwww.w.
w.wwXXwX..ww......ww..XwXXww.w
w..w.w...w.X..ww..X.w...w.w..w
Xw.Xwww.w.....ww.....w.wwwX.wX
w.ww.w...Xw.w....w.wX...w.ww.w
.w..wwww.X.wwXwwXww.X.wwww..w.
www.www..w.www..www.w..www.www
w......ww.w...ww...w.ww......w
w......ww.w...ww...w.ww......w
www.www..w.www..www.w..www.www
.w..wwww.X.wwXwwXww.X.wwww..w.
w.ww.w...Xw.w....w.wX...w.ww.w
Xw.Xwww.w.....ww.....w.wwwX.wX
w..w.w...w.X..ww..X.w...w.w..w
w.wwXXwX..ww......ww..XwXXww.w
.w.wwwww.www..XX..www.wwwww.w.
w...X...ww.Xw.ww.wX.ww...X...w
w..wX.wXw.w.ww..ww.w.wXw.Xw..w
w..w..ww..wwXXwwXXww..ww..w..w
w.w.w..w.wwwww..wwwww.w..w.w.w
..w.ww.w..w.w.ww.w.w..w.ww.w..
o.ww....wXXwwwXXwwwXXw....ww.o
