o...wwXXXw..wXXXXw..wXXXww...o
.wwwXX....w...ww...w....XXwww.
X..X..wXw.XXw.ww.wXX.wXw..X..X
wX.X...XwX...X..X...XwX...X.Xw
wXXX.w.X.XXXwX..XwXXX.X.w.XXXw
w.w.X.wXwX.X.wwww.X.XwXw.X.w.w
wwwwX.w..wX...ww...Xw..w.Xwwww
XX.ww..w.w.ww.ww.ww.w.w..ww.XX
..X.XwX.w.w.w.ww.w.w.w.XwX.X..
wwX.wwX..wwwwwXXwwwww..Xww.Xww
..w.wXXXXw...XwwX...wXXXXw.w..
wXX....X.wXXXXwwXXXXw.X....XXw
ww.X.w.XX.X.w.ww.w.X.XX.w.X.ww
XXw.w.XXw.XXw....wXX.wXX.w.wXX
XXw.w.XXw.XXw....wXX.wXX.w.wXX
ww.X.w.XX.X.w.ww.w.X.XX.w.X.ww
wXX....X.wXXXXwwXXXXw.X....XXw
..w.wXXXXw...XwwX...wXXXXw.w..
wwX.wwX..wwwwwXXwwwww..Xww.Xww
..X.XwX.w.w.w.ww.w.w.w.XwX.X..
XX.ww..w.w.ww.ww.ww.w.w..ww.XX
wwwwX.w..wX...ww...Xw..w.Xwwww
w.w.X.wXwX.X.wwww.X.XwXw.X.w.w
wXXX.w.X.XXXwX..XwXXX.X.w.XXXw
wX.X...XwX...X..X...XwX...X.Xw
X..X..wXw.XXw.ww.wXX.wXw..X..X
.wwwXX....w...ww...w....XXwww.
o...wwXXXw..wXXXXw..wXXXww...o
